..................................................
..................................................
..................................................
..................................................
..................................................
..................................................
#######################sssssss####################
..................................................
..................................................
..................................................
..................................................
..................................................
..................................................
..................................................
...........#######################################
..................................................
..................................................
..................................................
..................................................
..................................................
..................................................
..................................................
#####################################.............
........#.........................................
........#.........................................
........#.........................................
........#.........................................
........#.........................................
........#.........................................
........#.........................................
........#.........................................
................##################################
..................................................
..................................................
..................................................
..................................................
..................................................
..................................................