..................................................
..................................................
..................................................
..................................................
..................................................
..................................................
..................................................
..................................................
..................................................
..................................................
..................................................
..................................................
.......###########................................
......#...........................................
..................................................
..................................................
.........................................#########
#.................................................
##................................................
###...............................................
###.....................############..........#...
..................................................
..................................................
..................................................
.###..............................................
..................................................
....####..........................................
..................................................
..........####....................................
..................................................
...............############...###.................
................................####..............
......................................##..........
.................................................#
................................................##
.....#.........................................###
.....#........................................####
§....#......................................######