..................................................
..................................................
..................................................
..................................................
..................................................
..................................................
..................................................
..................................................
..................................................
..................................................
..................................................
..................................................
..................................................
..................................................
..................................................
..................................................
..................................................
..................................................
..................................................
..................................................
..................................................
#.................................................
##................................................
###...............................................
####..............................................
#####.............................................
######............................................
#######...........................................
########..........................................
#########.........................................
##########........................................
###########.......................................
############......................................
#############.....................................
##############....................................
###############...................................
################..................................
#################.................................